%%%%%%%%%%
%R       %
%  %%%%% %
%  %     %
%  % T % %
%  %   % %
%  %M  % %
%  %S  % %
%  %%%%% %
%        %
%%%%%%%%%%