%%%%%%%%%
%R      %
%  %%%% %
%  %    %
%  % T  %
%  %    %
%  %M   %
%  %S   %
%  %%%% %
%       %
%%%%%%%%%