%%%%%%
%R...%
%% %.%
%TS.M%
%%%%%%